jurado para trabajo de ascenso
Con base en la propuesta presentada por la División de Ciencias Físicas y Matemáticas y la División de Ciencias y Tecnologías Administrativas e Industriales, fueron designados los jurados que habrán de conocer los siguientes trabajos de ascenso:

“ELECTRODOS QUIMICAMENTE MODIFICADOS CON CARACTERISTICAS ÚTILES EN EL DESARROLLO DE SENSORES ELECTROQUÍMICOS”,  presentado por la profesora LENYS FERNÁNDEZ, adscrita al departamento de Química, para su ascenso a la categoría de TITULAR. El jurado quedó conformado por los siguientes profesores:

Prof.  Roberto Requiz	Presidente
Prof.  Gilberto Jorge	Miembro principal externo
Prof.  Olga Márquez	Miembro principal externo
Prof.  Lorenzo Echeverría	Miembro suplente interno
Prof.  Matilde Fernández	Miembro suplente externo


“CONTRIBUCIÓN AL DESARROLLO DE LA INGENIERÍA TELEMÁTICA EN LA USB”,  presentado por la profesora MONICA HUERTA, adscrita al departamento de Electrónica y Circuitos, para su ascenso a la categoría de TITULAR. El jurado quedó conformado por los siguientes profesores:

Prof.  Luis Urbano	Presidente
Prof.  Emilio Hernández	Miembro principal interno
Prof.  Antonino Caralli	Miembro principal externo
Prof.  José Restrepo	Miembro suplente interno
Prof.  Armando Borrero	Miembro suplente externo


“BLENDED LEARNING EN EL CONTEXTO DE LA EDUCACIÓN VENEZOLANA”,  presentado por la profesora ÁNGELA CHIKHANI, adscrita al departamento de Tecnología Industrial, para su ascenso a la categoría de TITULAR. El jurado quedó conformado por los siguientes profesores:

Prof.  Adelaide Bianchini	Presidente
Prof.  María Angelica Pérez	Miembro principal interno
Prof.  Alejandra Fernández	Miembro principal externo
Prof.  Migdy Chacín	Miembro suplente de la Prof. María Angélica Pérez
Prof.  Ana Beatriz Martínez	Miembro suplente de la Prof. Alejandra Fernández

De conformidad con lo solicitado por el Consejo Directivo en sesión del 06/04/2011 es  informado a este Cuerpo en sesión del 2011-08 del 13/04/2011, sobre la reposición del proceso de ascenso en el escalafón universitario de la profesora Ángela Chikhani, al estado en el que el Consejo Académico designe un nuevo jurado que conozca el trabajo de la profesora Chikhani, el Director (E) de la División de Ciencias y Tecnologías Administrativas e Industriales presentó la propuesta de una nueva conformación del jurado.
