jurado para trabajo de ascenso
“ADAPTACIÓN DE UN MÉTODO DE DETECCIÓN DE LATIDOS Y DE SEGMENTACIÓN DEL ELECTROCARDIOGRAMA AL NEONATO PREMATURO PARA CARACTERIZAR EPISODIOS DE APNEA-BRADICARDIA”,  presentado por el profesor MIGUEL ALTUVE, adscrito al departamento de Tecnología Industrial, para su ascenso a la categoría de AGREGADO. El jurado quedó conformado por los siguientes profesores:
Prof.  Pedro Gomis	Presidente
Prof.  Liliana Gavidia	Miembro principal interno
Prof.  Guillermo Montilla	Miembro principal externo
Prof.  Antonio Salazar	Miembro suplente interno
Prof.  Rubén Rojas	Miembro suplente externo
“APORTACIÓN A LOS ESTUDIOS DE ESPECIALIZACIÓN DE LOS COMPLEJOS DE VANADIO (III) Y CROMO (III) CON ALGUNOS BIOLIGANDOS”,  presentado por el profesor VITO LUBES, adscrito al departamento de Química, para su ascenso a la categoría de TITULAR. El jurado quedó conformado por los siguientes profesores:
Prof.  Carlos Borras	Presidente
Prof.  Eloy Rodríguez	Miembro principal interno
Prof.  Juan Niclós Gutiérrez	Miembro principal externo
Prof.  Jorge Mostany	Miembro suplente interno
Prof.  Antonio Bianchi	Miembro suplente externo
“APLICACIÓN DE LA EDUCACIÓN DE ESTADO DE BASE MOLECULAR SPHCT PARA LA PREDICCIÓN DEL EQUILIBRIO DE FASES EN SISTEMAS n-ALCANO-HIDRÓGENO”,  presentado por el profesor ALEXIS BOUZA, adscrito al departamento de Termodinámica y Fenómenos de Transferencia, para su ascenso a la categoría de ASOCIADO. El jurado quedó conformado por los siguientes profesores:
Prof.  Jean-Marie Ledanois	Presidente
Prof.  Susana Bottini	Miembro principal externo
Prof.  Angel Mulero	Miembro principal externo
Prof.  Marcelo Castier	Miembro suplente de la Prof. Bottini
Prof.  Martín Aznar	Miembro suplente del Prof. Mulero
Se instó a los Directores de División a instruir a los Departamentos a que