
Jurados de Trabajo de Ascenso
	Con base en la propuesta presentada por las Divisiones de Ciencias  Sociales y Humanidades y 	Ciencias Físicas y Matemáticas,  fue designado el  jurado que habrá  de conocer los siguientes 	trabajos de ascenso:

“EJERCICIOS ESPIRITUALES, OBRA PARA CORO MIXTO Y ORQUESTA SINFÓNICA COMPUESTA POR DIANA ARISMENDI”,  presentado por la profesora DIANA ARISMENDI, adscrita al Departamento de Ciencias Sociales, a los fines de su ascenso a la categoría de TITULAR.   El jurado quedo conformado por los siguientes profesores:

Prof. Adina Izarra	Presidente
Prof. Abraham Abreu	Miembro principal interno
Maestro Inocente Carreño	Miembro principal externo
Prof. Marisela González	Miembro suplente interno
Prof. María Antonia Palacios	Miembro suplente externo


“ESTRUCTURAS METÁLICAS EN LA ARQUITECTURA VENEZOLANA 1874-1935: EL CARÁCTER DE LA TÉCNICA”, presentado por la profesora MÓNICA SILVA, adscrita al Departamento de Diseño, Arquitectura y Artes Plásticas, a los fines de su ascenso a la categoría de AGREGADO.  El jurado quedó conformado por los siguientes profesores:

Prof. Enrique Larrañaga	Presidente
Prof. Roberto Rodríguez	Miembro principal interno
Prof. José Rosas Vega	Miembro principal externo
Prof. Roger Corbacho	Miembro suplente interno
Prof. Bernardo Moncada	Miembro suplente externo


“TIEMPOS DE FIESTAS, PODER Y ESCRITURA DE MUJER, ESTUDIO DEL PRIMERO CENTENARIO DEL NATALICIO DE SIMÓN BOLÍVAR (1883) Y DE ANTONIO JOSÉ DE SUCRE (1895), presentado por la profesora CARMEN AMÉRICA AFFIGNE, adscrita al Departamento de Lengua y Literatura, a los fines de su ascenso a la categoría de AGREGADO.  El jurado quedó conformado por los siguientes profesores:

Prof. Paulette Silva	Presidente
Prof. Carole Leal	Miembro principal interno
Prof. Laura Febres	Miembro principal externo
Prof. Josefina Berrizbeítia	Miembro suplente interno
Prof. Luz Marina Rivas	Miembro suplente externo


“SERVICIOS DE INFRAESTRUCTURA HIDRÁULICA: PLANIFICACIÓN, DISEÑO Y GESTIÓN, DESDE UNA PERSPECTIVA URBANÍSTICA”,  presentado por el profesor ROGER MARTÍNEZ, adscrito al Departamento de Planificación Urbana, a los fines de su ascenso a la categoría de ASOCIADO.  El jurado  quedó conformado por los siguientes profesores:

Prof. Lorenzo González	Presidente
Prof. Arnoldo José Gabaldón	Miembro principal interno
Prof. Marco Negrón	Miembro principal externo
Prof. Víctor Fossi	Miembro suplente interno
Prof. Luis Enrique Franceschi	Miembro suplente externo


“EL INFINITO MATEMÁTICO Y EL FRACTAL: ACERCAMIENTO COGNITIVO CON INTÉRES DIDÁCTICO”, presentado por la profesora SABRINA GARBÍN, adscrita al Departamento de Matemáticas 	Puras y Aplicadas, a los fines de su ascenso a la categoría de ASOCIADO.  El jurado quedó conformado por los siguientes profesores:

Prof. Eduardo Lima de Sá	Presidente
Prof. Enrique Planchart	Miembro principal interno
Prof. José Ortíz	Miembro principal externo
Prof. Alicia Cardozo	Miembro suplente interno
Prof. Matías Camacho	Miembro suplente externo


“SOBRE EL LEMA DE CONEXIÓN DE HAYASI: UN REFINAMIENTO Y SOBRE LA NO VERSALIDAD DE LA BIFURCACIÓN DE ANDRONOV-HOPF PARA DIFEOMORFIMOS”, presentado por el profesor JOSÉ CARLOS MARTÍN, adscrito al Departamento de Matemáticas Puras y Aplicadas, a los fines de ascenso a la categoría de TITULAR.  El jurado quedó conformado por los siguientes profesores:

Prof. Lázaro Recht	Presidente
Prof. Víctor Sirvent	Miembro principal interno
Prof. Jorge Lewowicz	Miembro principal externo
Prof. Enrique Planchart	Miembro suplente interno
Prof. Neptalí Romero	Miembro suplente externo


“TÉCNICAS AVANZADAS DE AYUDA A LA CONMUTACIÓN PARA DISPOSITIVOS ELECTRÓNICOS DE POTENCIA”,  presentado por el profesor GERARDO CEGLIA, adscrito al Departamento de Electrónica y Circuitos, a los fines de su ascenso a la categoría de ASOCIADO.  El jurado quedó conformado por los siguientes profesores:

Prof. Francisco García Sánchez	Presidente
Prof. José Manuel Aller	Miembro principal interno
Prof. Enrique Dede	Miembro principal externo
Prof. Gerardo Fernández	Miembro suplente interno
Prof. Abelardo Martínez	Miembro suplente externo


“ACTIVIDADES EN TECNOLOGÍA ASISTIVA, ADQUISICIÓN Y ANÁLISIS DE BIO-SEÑALES Y EDUCACIÓN EN INGENIERÍA ELECTRÓNICA”, presentado por el  profesor ANTONIO SALAZAR, adscrito al Departamento de Electrónica y Circuitos, a los fines de su ascenso  a la categoría de AGREGADO.  El jurado quedó conformado por los siguientes profesores:

Prof. Trina Adrián 	Presidente
Prof. Carlos González	Miembro principal interno
Prof. Antonio Bosnjak	Miembro principal externo
Prof. Luis Loreto	Miembro suplente interno
Prof. Rubén Medina	Miembro suplente externo



“MODELO NUMÉRICO PARA PREDECIR EL COMPORTAMIENTO ÓPTIMO DE LA MOCROESTRUCTURA DE LAS SOLDADURAS DE ACERO INOXIDABLE DÚPLEX”, presentado por la profesora MARÍA CAROLINA PAYARES DE ASPRINO, adscrita al Departamento de Mecánica, a los fines de ascenso a la categoría de TITULAR. El jurado quedó conformado por los siguientes profesores:

Prof. Germán Crespo 	Presidente
Prof. Manuel Alfredo Dávila	Miembro principal interno
Prof. Eli Saúl Puchi	Miembro principal externo
Prof. Zulay Cassier	Miembro suplente interno
Prof. Amado Quintero	Miembro suplente externo


“ELECTRÓDOS QUÍMICAMENTE MODIFICADOS CON PELÍCULAS DE ARCILLAS TIPO HIDROTALCITAS Y DIFERENTES TIPOS DE SURFACTANTES”, presentado por la profesora LENYS FERNÁNDEZ, adscrita al Departamento de Química, a los fines de su ascenso a la categoría de ASOCIADO.   El jurado quedó conformado por los siguientes profesores:

Prof. Roberto Réquiz 	Presidente
Prof. Angela Cuenca	Miembro principal interno
Prof. Reynaldo Ortíz	Miembro principal externo
Prof. Matilde Fernández	Miembro suplente interno
Prof. Gilberto Jorge	Miembro suplente externo



--------------------------------


Informe
Informe
Informe
Informe
Informe

--------------------------------

