Jurados de trabajo de ascenso
Con base en la propuesta presentada por las Divisiones de Ciencias Sociales y Humanidades, Ciencias Biológicas y Ciencias y Tecnologías Administrativas e Industriales, fueron designados los  jurados que habrán  de conocer los siguientes trabajos de ascenso:
    “LA SUBJETIVIDAD SOCIAL EN CONSTRUCCIÓN DEL “MOVIMIENTO ANTIGLOBALIZACIÓN””, presentado por  la profesora MARÍA TERESA URREIZTIETA, adscrita al Departamento de Ciencia y Tecnología del Comportamiento, a los fines de su ascenso a la categoría de TITULAR. El jurado quedó conformado por los siguientes profesores:

Prof. María Pilar García	Presidente
Prof. Silverio González	Miembro principal interno
Prof. Daniel Mato	Miembro principal externo
Prof. Makram Haluani	Miembro suplente interno
Prof. Omar Astorga	Miembro suplente externo

	“LA SEGURIDAD ALIMENTARIA EN HOGARES: UN COMPENDIO DE ESTUDIOS EN VENEZUELA”, presentado por la profesora JENNIFER BERNAL, adscrita a ese departamento, para su promoción a la categoría de ASOCIADO, el cual quedó integrado por los siguientes profesores:

Prof. Yolanda H. de Valera	Presidente
Prof. Marino J. González	Miembro principal interno
Prof. Andrés Carmona	Miembro principal externo
Prof. Marisa Guerra	Miembro suplente interno
Prof. Luis Falque	Miembro suplente externo

    	“LA GESTIÓN DE INFORMACIÓN FACTOR ESTRATÉGICO DE LAS ORGANIZACIONES”, presentado por la profesora MARÍA REIMI MACHEZ, adscrita al Departamento de Tecnología de Servicios, a los fines de su ascenso a la categoría de ASOCIADO.  Este jurado había sido designado con anterioridad, pero debido a la renuncia del Prof. Carlos Figueira, Presidente del Jurado, fue presentado nuevamente ante el Consejo Académico para su consideración y el mismo  quedó conformado por los siguientes profesores:

Prof. Emilio Hernández	Presidente
Prof. María Angélica Pérez de Ovalles	Miembro principal interno
Prof. Iraiza Morillo	Miembro principal externo
Prof. Freddy Rojas	Miembro suplente interno
Prof. Emil Hernández	Miembro suplente externo

	“ESTABILIDAD DINÁMICA DE SISTEMAS DE POTENCIA”,  presentado por el profesor JESÚS RAFAEL PACHECO PIMENTEL, adscrito al Departamento de Tecnología Industrial, a los fines de su ascenso a la categoría de TITULAR. El jurado quedó conformado por los siguientes profesores:

Prof. Elmer Sorrentino	Presidente
Prof. Gastón Pesse	Miembro principal interno
Prof. Celso Fortoul	Miembro principal externo
Prof. Juan Bermúdez	Miembro suplente interno
Prof. Mario Morales	Miembro suplente externo
