Jurados de trabajo de ascenso
Con base en la propuesta presentada por las Divisiones de Ciencias Físicas y Matemáticas y Ciencias Sociales y Humanidades, fueron designados los  jurados que habrán  de conocer los siguientes trabajos de ascenso:
“CONTRIBUCIONES A LENGUAJES DE CONSULTAS BASADAS EN PREFERENCIAS”, presentado por la profesora MARLENE GONCALVES,  adscrita al Departamento de Computación y Tecnología de la Información, para su ascenso a la categoría de ASOCIADO.  El jurado quedó conformado por los siguientes profesores:

Prof. Soraya Abad	Presidente
Prof. Rosalía Lamanna	Miembro principal interno
Prof. José Aguilar	Miembro principal externo
Prof. Edna Ruckhaus	Miembro suplente interno
Prof. Isabel Besembel	Miembro suplente externo

“ANÁLISIS ESPECTRAL DE OPERADORES DEL MODELO DE FRIEDRISCHS DE TIPO ABSOLUTO”,  presentado por el profesor SERGUEI IAKOVLEB,  adscrito al Departamento de Matemáticas Puras y Aplicadas, para su ascenso a la categoría de TITULAR.  El jurado quedó conformado por los siguientes profesores:

Prof. Vladimir Strauss	Presidente
Prof. Stefania Marcantognini	Miembro principal interno
Prof. Diómedes Barcenas	Miembro principal externo
Prof. Andrea Stephen	Miembro suplente interno
Prof. Ramón Bruzual	Miembro suplente externo

“LAMINACIÓN EN CALIENTE DE UN COBRE ELECTROLÍTICO”, de la profesora MARY TORRES, adscrita al Departamento de Mecánica, para su ascenso a la categoría de TITULAR.  El jurado quedó conformado por los siguientes profesores:

Prof. Héber D’Armas	Presidente
Prof. Ana Rivas	Miembro principal interno
Prof. Eli Saúl Puchi	Miembro principal externo
Prof. Germán Crespo	Miembro suplente interno
Prof. Laura Sáenz	Miembro suplente externo

“LO REAL MARAVILLOSO EN LA OBRA DE SIMONE SCHAWARZ-BART”, presentado por la profesora OLGA MARIELLA AITA,  adscrita al Departamento de Idiomas, para su ascenso a la categoría de ASOCIADO.  El jurado quedó conformado por los siguientes profesores:

Prof. Sonia García	Presidente
Prof. Coral Delgado	Miembro principal interno
Prof. Elie-Paul Rouche	Miembro principal externo
Prof. Josefina Berrizbeitia	Miembro suplente interno
Prof. Frances D. de Erlich	Miembro suplente externo