
Jurados de trabajo de ascenso
Con base en la propuesta presentada por las Divisiones de Ciencias Sociales y Humanidades, Ciencias Biológicas y Ciencias y Tecnologías Administrativas e Industriales, fueron designados los  jurados que habrán  de conocer los siguientes trabajos de ascenso:
 “SOCIEDADES EN TRANSICIÓN DURANTE LA CONQUISTA DE LA PROVINCIA DE VENEZUELA”, presentado por la profesora OTILIA ROSAS GONZÁLEZ,  adscrita al Departamento de Ciencias Sociales, para su ascenso a la  categoría de AGREGADO.  El jurado quedó conformado por los siguientes profesores:
Prof. Jesús Herrera	Presidente
Prof. Consuelo Cal	Miembro principal interno
Prof. Rafael Strauss	Miembro principal externo
Prof. Luis Buttó	Miembro suplente interno
Prof. Catalina Banko	Miembro suplente externo

“EFECTOS DE LOS ESTILOS DE APRENDIZAJE Y LA AUTOEFICACIA COMPUTACIONAL SOBRE EL DESEMPEÑO EN FORO ELECTRÓNICO”, presentado por la profesora SOFIA PEINADO,  adscrita al Departamento de Ciencia y Tecnología del Comportamiento, para su ascenso a la categoría de AGREGADO.  El jurado quedó conformado por los siguientes profesores:
Prof. Dafne González	Presidente
Prof. Alicia Cardozo	Miembro principal interno
Prof. Haydee Páez	Miembro principal externo
Prof. Mariela Azzato	Miembro suplente interno
Prof. Lisette Poggioli	Miembro suplente externo

“EL ESPACIO DE LA FRUICIÓN: LA PERSISTENCIA DE LO OTRO EN EL IMAGINARIO MODERNO”, presentado por el profesor JORGE VILLOTA,  adscrito al Departamento de Diseño, Arquitectura y Artes Plásticas, para su ascenso a la categoría de ASOCIADO.  El jurado quedó conformado por los siguientes profesores:
Prof. Enrique Larrañaga	Presidente
Prof. María Elena Gómez	Miembro principal interno
Prof. Alfonso José Arellano	Miembro principal externo
Prof. Sandra Pinardi	Miembro suplente interno
Prof. Horacio Biord	Miembro suplente externo

“DIOS, SER Y REALIDAD”, presentado por el profesor NELSON TEPEDINO,  adscrito al Departamento de Filosofía, para su ascenso a la categoría de TITULAR. El jurado quedó conformado por los siguientes profesores:
Prof. Rafael Tomás Caldera	Presidente
Prof. Luis Miguel Isava	Miembro principal interno
Prof. Luz Marina Barreto	Miembro principal externo
Prof. Arturo Almandoz	Miembro suplente interno
Prof. Lionel Pedrique Orta	Miembro suplente externo

“RETAZOS Y FRAGMENTOS. UNA BIOGRAFÍA DE TERESA CARREÑO”, presentado por la profesora VIOLETA ROJO,  adscrita al Departamento de Lengua y Literatura, para su ascenso a la categoría de TITULAR.  El jurado quedó conformado por los siguientes profesores:
Prof. Carmen Elena Alemán	Presidente
Prof. Marisela González	Miembro principal interno
Prof. Gregory Zambrano	Miembro principal externo
Prof. Josefina Berrizbeitia	Miembro suplente interno
Prof. Douglas Bohórquez	Miembro suplente externo

“ANFIPODOS DE VENEZUELA (CRUSTACEA: CAPRELLIDAE Y GAMMARIDEA): TAXONOMIA, BIOLOGÍA Y ECOLOGÍA”, presentado por el profesor ALBERTO MARTÍN ZAZO, adscrito al Departamento Estudios Ambientales, para su ascenso a la categoría de TITULAR.  El jurado quedó conformado por los siguientes profesores:
Prof. Marisol Aguilera	Presidente
Prof. César Lodeiros	Miembro principal externo
Prof. Jean Claude Sorbe	Miembro principal externo
Prof. Evelyn Zoppi de Roa	Miembro suplente externo
Prof. Juan María Junoy	Miembro suplente externo

Antes de discutir este

--------------------------------

