
Jurados  para trabajo de ascenso
Con base en la propuesta presentada por las Divisiones de Ciencias Físicas y Matemáticas; Ciencias Sociales y Humanidades y Ciencias y Tecnologías Administrativas e Industriales, fueron designados los  jurados que habrán  de conocer los siguientes trabajos de ascenso:
   “EFECTO DE ZENON, ESPACIOS LIBRES DE DECOHERENCIA Y DISCRIMINACIÓN DE MEDIDAS CUÁNTICAS”, presentado por el profesor DOUGLAS MUNDARAIN,  adscrito al Departamento de Física, para su ascenso a la categoría de TITULAR. El jurado quedó conformado por los siguientes profesores:

Prof. Cayetano Di Bartolo	Presidente
Prof. Alvaro Restucia	Miembro principal interno
Prof. Lorenzo Leal	Miembro principal externo
Prof. Rita Gianvittorio	Miembro suplente interno
Prof. Ernesto Medina	Miembro suplente externo

    “TÓPICOS SOBRE REVALORIZACIÓN DE MATERIALES CARBONOSOS: COQUE DE PETRÓLEO Y LICOR NEGRO DE KRAFT”, presentado por la profesora LUISA ANGELICA DELGADO,  adscrita al Departamento de Procesos y Sistemas, para su ascenso a la categoría de TITULAR.  El jurado quedó conformado por los siguientes profesores:

Prof. María Mercedes Pérez	Presidente
Prof. Carmen Rosales	Miembro principal interno
Prof. Joaquín Brito	Miembro principal externo
Prof. Rafael López	Miembro suplente interno
Prof. Carmelo Bolívar	Miembro suplente externo

    “LAS CARAS DE LA TRAMPA”, presentado por la profesora ISABEL RODRÍGUEZ,  adscrita al Departamento de Lengua y Literatura, para su  ascenso a la categoría de ASOCIADO.  El jurado quedó conformado por los siguientes profesores:

Prof. Carmen Elena Alemán	Presidente
Prof. María Eugenia Talavera	Miembro principal interno
Prof. Minelia de Ledezma	Miembro principal externo
Prof. Nelson Tepedino	Miembro suplente interno
Prof. Magaly Salazar	Miembro suplente externo

    “CRECIMIENTO Y DESARROLLO.  CASO: DESARROLLO SOSTENIBLE EN LA INDUSTRIA DEL ALUMINIO EN VENEZUELA 2000-2006”, presentado por las profesoras MARITZA NERIS Y EVELYN LOBO (trabajo conjunto de ascenso),  adscritas al Departamento de Tecnología de Servicios,  para su ascenso a la categoría de ASOCIADO.  El jurado quedó conformado por los siguientes profesores:

Prof. Rosa Chacón	Presidente
Prof. Servando Álvarez	Miembro principal interno
Prof. Antonio de Lisio	Miembro principal externo
Prof. Nelson Geigel Lópe-Bello	Miembro suplente interno
Prof. Manuel Garaicochea	Miembro suplente externo


--------------------------------

