
jurado para trabajo de ascenso
Con base en la propuesta presentada por la División de Ciencias Físicas y Matemáticas y por la División de Ciencias y Tecnologías Administrativas e Industriales, fueron designados los jurados que habrán de conocer los siguientes trabajos de ascenso:

“DISPONIBILIDAD DE MACRO Y MICRONUTRIENTES Y EVALUACIÓN DEL ESTADO NUTRICIONAL EN CONDICIONES DE SALUD O ENFERMEDAD”,  presentado por la profesora DIAMELA CARIAS, adscrita al departamento de Tecnología de Procesos Biológicos, para su ascenso a la categoría de TITULAR. El jurado quedó conformado por los siguientes profesores:

Prof.  Marisa Guerra	Presidente
Prof.  Virgilio Bosch	Miembro principal externo
Prof.  María de las Nieves García	Miembro principal externo
Prof.  Marisela Granito	Miembro suplente interno del Prof. Virgilio Bosch
Prof.  Mercedes Schnell	Miembro suplente externo de la Prof. María de las Nieves García


“ARTÍCULOS EN FISICA DE SOLIDOS, CALENTAMIENTO INDUCTIVO, ELECTRÓNICA DE POTENCIA Y ENERGÍAS ALTERNATIVAS”,  presentado por el profesor JULIO WALTER, adscrito al departamento de Electrónica y Circuitos, para su ascenso a la categoría de TITULAR. El jurado quedó conformado por los siguientes profesores:

Prof.  José Restrepo	Presidente
Prof.  José Manuel Aller	Miembro principal interno
Prof.  Vicente Esteve Gómez	Miembro principal externo
Prof.  Alexander Bueno	Miembro suplente interno
Prof.  Diodoro Iacocca	Miembro suplente externo



“INSTRUMENTOS MULTILATERALES DEL COMERCIO INTERNACIONAL Y SUS EFECTOS EN LA POLÍTICA AGRÍCOLA COMERCIAL DE LA REPÚBLICA DE BRASIL Y DE LA UNIÓN EUROPEA. INTERCAMBIO COMERCIAL UNIÓN EUROPEA – COMUNIDAD ANDINA (1997 – 2007)”,  presentado por la profesora  MARÍA GUERRA, adscrita al departamento de Tecnología de Servicios, para su ascenso a la categoría de TITULAR. El jurado quedó conformado por los siguientes profesores:

Prof.  Servando Álvarez	Presidente
Prof.  Makram Haluani	Miembro principal interno
Prof.  Sary Levy	Miembro principal externo
Prof.  Friedrich Welsch	Miembro suplente interno
Prof.  Demetrio Boersner	Miembro suplente externo



“APORTES AL RECONOCIMIENTO DE PATRONES EN SEÑALES NO ESTACIONARIAS”  presentado por la profesora  KLEYDIS SUÁREZ, adscrita al departamento de Tecnología de Industrial, para su ascenso a la categoría de ASOCIADO. El jurado quedó conformado por los siguientes profesores:

Prof.  Fernando Mora	Presidente
Prof.  Ricardo Silva	Miembro principal interno
Prof.  Guillermo Montilla	Miembro principal externo
Prof.  Luis Lara Estrella	Miembro suplente interno
Prof.  Antonio Bosnjak	Miembro suplente externo



“ESTILO GERENCIAL Y CAMBIO ORGANIZACIONAL EN LOS DEPARTAMENTOS ACADÉMICOS DE LA DIVISIÓN DE CIENCIAS Y TECNOLOGÍAS ADMINISTRATIVAS E INDUSTRIALES DE LA UNIVERSIDAD SIMÓN BOLÍVAR. HACIA UNA PROPUESTA DE UN ESTILO GERENCIAL FUNDAMENTADO BAJO LOS PRINCIPIOS DEL COACHING TRANSFORMACIONAL”  presentado por la profesora  ELBA MÁRQUEZ, adscrita al departamento de Tecnología de Servicios, para su ascenso a la categoría de ASOCIADO. El jurado quedó conformado por los siguientes profesores:

Prof.  Guillermo Yáber	Presidente
Prof.  Belkys Jiménez	Miembro principal interno
Prof.  Miguel Mujica	Miembro principal externo
Prof.  Guillermo Álvarez	Miembro suplente interno
Prof.  Franklin Machado	Miembro suplente externo
Para evitar conflicto de intereses, durante la presentación de la propuesta de jurado de trabajo de ascenso de la profesora Elba Márquez, ésta abandonó la sala por estarse evaluando los miembros del jurado que evaluarán su trabajo.



--------------------------------

