
Jurado  para trabajo de ascenso
Con base en la propuesta presentada por las Divisiones de Ciencias Físicas y Matemáticas y Ciencias Biológicas,  fueron designados los  jurados que habrán  de conocer los siguientes trabajos de ascenso: 
“RACIONALIDAD ACOTADA Y SUBSIDIOS A LA COOPERACIÓN EN EL DILEMA DEL PRISIONERA ESPACIAL”, presentado por la profesora HAYDÉE LUGO, adscrita al Departamento de Computó Científico y Estadística,  a los fines de su ascenso a la categoría de ASOCIADO.  El jurado quedó conformado por los siguientes profesores:

José Luis Palacios	Presidente
Gabriela Ochoa	Miembro principal interno
Antonio Parravano	Miembro principal externo
Blai Bonet	Suplente interno
Mario Cosenza	Suplente externo

“USO DE METAHEURÍSTICAS EN EL DISEÑO DE QUIMIOTERAPIAS”, de la profesora MINAYA VILLASANA, adscrita al Departamento de Computó Científico y Estadística, a los fines de su ascenso a la categoría de ASOCIADO.  El jurado quedó conformado  por los siguientes profesores:

Henryk Gzyl	Presidente
Blai Bonet	Miembro principal interno
José Alí Moreno	Miembro principal externo
Raúl Jiménez	Suplente interno
Luisana Avilan	Suplente externo

“APRENDIZAJE DE COMPORTAMIENTOS Y DETECCIÓN DE PERSONAS EN ROBOTS MÓVILES”, presentado por la profesora CAROLINA CHANG, adscrita al Departamento de Computación y Tecnología de la información, a los fines de su ascenso a la categoría de ASOCIADO.  El jurado quedó conformado por los siguientes profesores:

Adolfo Quiroz	Presidente
Gerardo Fernández	Miembro principal interno
José Aguilar	Miembro principal externo
Blai Bonet	Suplente interno
Jacinto Dávila	Suplente externo

“DISEÑO DE SUPERFICIES DE RESPUESTA Y REDES ARTIFICIALES DE NEURONAS EN EL PROCESAMIENTO DE FRUTAS DE CONSUMO EN VENEZUELA”, presentado por el profesor FÉLIX RAFAEL MILLÁN , adscrito al Departamento de Procesos Biológicos y Bioquímicos, a los fines de su ascenso a la categoría de ASOCIADO.   El jurado quedó conformado por los siguientes profesores:

Marisela Granito	Presidente
Gerardo Bauce	Miembro principal externo
María S. Tapia	Miembro principal externo
José Barreira	Suplente interno
Otoniel Corzo	Suplente interno
i

--------------------------------

