
Jurado de Trabajo de Ascenso
Con base en la propuesta presentada por las Divisiones de Ciencias Físicas y Matemáticas y de Ciencias y Tecnologías Administrativas e Industriales, fue designado el  jurado que habrá  de conocer los siguientes trabajos de ascenso:


“DESARROLLO DE UN HORNO DE INDUCCIÓN CON CONTROL DE POTENCIA USANDO TÉCNICAS DE MODULACIÓN SOBRE UNA CARGA RESONANTE”, presentado por el profesor JULIO WALTER, adscrito al Departamento de Electrónica y Circuitos,  a los fines de su ascenso a la categoría de ASOCIADO.  El jurado quedó conformado por los siguientes profesores:

Prof. William Colmenares	Presidente
Prof. José Restrepo	Miembro principal interno
Prof. Abelardo Martínez	Miembro principal externo
Prof. Richard Rivas	Miembro suplente interno
Prof. Diadoro Iacocca	Miembro suplente externo


 “DESARROLLO DE PROYECTOS DE INVESTIGACIÓN EN LAS ÁREAS DE ROTODINÁMICA Y EDUCACIÓN REALIZADOS EN EL LABORATORIO DE DINÁMICA DE MÁQUINAS”, presentado por el profesor LUIS MEDINA, adscrito al Departamento Mecánica, a los fines de su ascenso a la categoría de ASOCIADO.  El jurado quedó conformado por los siguientes profesores:

Prof. Euro Casanova	Presidente
Prof. Marisol Delgado	Miembro principal interno
Prof. Mary Vergara	Miembro principal externo
Prof. Carmen Müller-Karger	Miembro suplente interno
Prof. Simón Morales	Miembro suplente externo




“APLICACIONES DE LÓGICA DIFUSA Y DE CONTROL CLÁSICO A SISTEMAS”, presentado por el Profesor MIGUEL STREFEZZA, adscrito al Departamento de Procesos y Sistemas, a los fines de su ascenso a la categoría de TITULAR.  El jurado quedó conformado por los siguientes profesores:

Prof. Rosalba Lamanna	Presidente
Prof. José Manuel Aller	Miembro principal interno
Prof. Eliécer Colina	Miembro principal externo
Prof. Armando Coello	Miembro suplente interno
Prof. Wladimir Rodríguez	Miembro suplente externo


“LA GESTIÓN DE INFORMACIÓN FACTOR  ESTRATÉGICO DE LAS ORGANIZACIONES”, presentado por la Profesora MARÍA REIMI MACHEZ, adscrita al Departamento de Tecnología de Servicios, a los fines de su ascenso a la categoría de ASOCIADO.   El jurado quedó conformado por los siguientes profesores:

Prof. Carlos Figueira	Presidente
Prof. Angélica Ovalles de Pérez	Miembro principal interno
Prof. Iraiza Morillo	Miembro principal externo
Prof. Freddy Rojas	Miembro suplente interno
Prof. Emil Hernández	Miembro suplente externo



--------------------------------

